****************
*         *   E*
*    *    *  ***
*    *    *    *
*    *    *    *
*    *    *    *
*S   *    *    *
****************